11111111111111111111111111111111111111111111111111111111111111111111111111111111
11111111111111111111111111111111111111110000000000E11111111111111111111111111111
11111111111111111111111111111111111111000111111111111111111111111111111111111111
1111111111111111111111111111110000000000000C111111111111111111111111111111111111
11111111111111111111111111111100011111111110000001111111111111111111111111111111
1111111111111111111110000000000111111111111111C00C111111111111111111111111111111
11111111111111111111111111111000111111111111100011111111111111111111111111111111
11111111111111111111111111100000000000000000000011111111111111111111111111111111
11111111111111111111111100000111111111111111111111111111111111000P00111111111111
111111111111111111111111C1111111111111111111111111111111111111000000001111111111
11111111111111111111111100011111111111111111111111111111111000000000000001111111
11111111111111111111111100000111111111111111111111111111111000000011111111111111
111111111111111111111111000000000C0000000000111111111111111110111001111111111111
11111111111111111111111111111111100000000000000111111111111100011C11111111111111
111111111111111111111111111111111000000000000000001111111111C0001111111111111111
11111111111111111111111111111111111111111111100000000000000000011111111111111111
11111111111111111111111111111111111111111111111111111111111111111111111111111111