111111111111111
1000P000000E001
1000000C000F001
1000000000C0001
111111111111111
