111111111111111111111111111111111111111111111111111111111111
1EKKCCCCCCCCCCCCCCCCCCCCCCCCCCCCCCCCCCCCCCCCCCCCCCCCCCCCCCE1
10000000000000000000000000000000CCC00000CC00000000000C000001
1CCCCCCCCCCCCCCCCCCCCCCCCCCCCCC00000CCC0000CCCCCCCCC000CCC01
1CCCCCCCCCCCCCCCCCCCCCCCCCCCCCC00C00CCCCCCCCCCCCCCCCCCCCCCC1
1CCCCC00000000000CCCCCCCCC000000CC0000CCCCCCCCCCCCCCCCCCCCC1
1CCCCCCCCCCC0000000CCCCCCCCC00C0CCCCC00000000000000000CCCCC1
100000000000000000000000000000000000000000000000000000000001
10000000000000000000000000000000000000000000000000000P000001
100000000000CCCCCCCCCCCCCC000000000CCCCCCCCCCCCCCCCCCCCCCCC1
111111111111111111111111111111111111111111111111111111111111
