111111111111111
1P0000000000001
111111110000001
111111000000001
1E1111111111101
100000000000001
111111111111111
