111111111111111111111111111111111111111111111111111111
111111111111111111110000000000E11111111111111111111111
1111111111111111110B0111111111111111111111111111111111
111111111100000000CC000C111111111111111111111111111111
11111111110B011111111110000B01111111111111111111111111
1C00000C000111111111111111C00C111111111111111111111111
111111111B001111111111111BB011111111111111111111111111
111111100000000000000000000011111111111111111111111111
11110000B111111111111111111111111111111111000P00111111
1111C111111111111111111111111111111111111100B0B0001111
111100011111111111111111111111111111111B0000B0B0000001
11110B000111111111111111111111111111111B00BB0011111111
1111000B00000C0000B000B0111111111111111110110001111111
1111111111111B0B000F0000001111111111111B0011C111111111
111111111111100B000000B000B0001111111111C0B01111111111
1111111111111111111111111000B0000000000000B11111111111
111111111111111111111111111111111111111111111111111111