111111111111111
1B00PCCCBCCECC1
1000000CCCCFCC1
100B000CBCCCCC1
111111111111111
